//1,2,3,4,5,6,7,8,9,10,11,12,13,14,15,16,17,18,19,20,21,22,23,24,25,26,27,28,29,30,31,32,33,34,35,36,37,38,39,40,41,42,43,44,45,46,47,48,49,50
100,100,100,100,100,100,100,100,100,100,100,100,100,100,100,100,100,100,100,100,100,100,100,100,100,100,100,100,100,100,100,100,100,100,100,100,100,100,100,100,100,100,100,100,100,100,100,100,100,100
100,100,100,100,100,100,100,100,100,100,100,100,100,100,100,100,100,100,100,100,100,100,100,100,100,100,100,100,100,100,100,100,100,100,100,100,100,100,100,100,100,100,100,100,100,100,100,100,100,100
100,100,100,100,100,100,100,100,100,100,100,100,100,100,100,100,100,100,100,100,100,100,100,100,100,100,100,100,100,100,100,100,100,100,100,100,100,100,100,100,100,100,100,100,100,100,100,100,100,100
100,100,100,100,100,100,100,100,100,100,100,100,100,100,100,100,100,100,100,100,100,100,100,100,100,100,100,100,100,100,100,100,100,100,100,100,100,100,100,100,100,100,100,100,100,100,100,100,100,100
100,100,0,0,0,0,0,100,0,0,0,100,0,0,0,100,100,0,0,0,100,100,0,0,0,100,100,0,0,0,100,100,0,0,0,0,100,100,0,0,0,0,0,0,0,0,0,0,100,100
100,100,0,0,0,0,0,100,0,0,0,100,0,0,0,100,100,0,0,0,100,100,0,0,0,100,100,0,0,0,100,100,0,0,0,0,100,100,0,0,0,0,0,0,0,0,0,0,100,100
100,100,0,0,0,0,0,100,0,0,0,100,0,0,0,100,100,0,0,0,100,100,0,0,0,100,100,0,0,0,100,100,0,0,0,0,100,100,0,0,0,0,0,0,0,0,0,0,100,100
100,100,0,0,0,0,0,100,0,0,0,100,0,0,0,100,100,0,0,0,100,100,0,0,0,100,100,0,0,0,100,100,0,0,0,0,100,100,0,0,0,0,0,26,0,0,302,0,100,100
100,100,0,0,100,100,100,100,0,0,100,100,0,0,0,100,100,0,0,0,100,100,0,0,0,100,100,0,0,0,100,100,0,0,0,100,100,100,100,100,100,100,100,100,100,100,100,100,100,100
100,100,0,0,100,100,100,100,0,0,100,100,0,0,0,100,100,0,0,0,100,100,0,0,0,100,100,0,0,0,100,100,0,0,0,100,100,100,100,100,100,100,100,100,100,100,100,100,100,100
100,100,0,0,0,100,100,100,0,0,0,100,0,0,0,100,100,0,0,0,100,100,0,0,0,100,100,0,0,0,100,100,0,0,0,0,100,100,0,0,0,0,0,0,0,0,0,0,100,100
100,100,0,0,0,100,100,100,0,0,0,100,0,0,0,100,100,0,0,0,100,100,0,0,0,100,100,0,0,0,100,100,0,0,0,0,100,100,0,0,0,0,0,0,0,0,0,0,100,100
100,100,0,0,0,100,100,100,0,0,0,100,0,0,0,100,100,0,0,0,100,100,0,0,0,100,100,0,0,0,100,100,0,0,0,0,100,100,0,0,0,0,0,0,0,0,0,0,100,100
100,100,0,0,0,100,100,100,0,0,0,100,0,0,0,100,100,0,0,0,100,100,0,0,100,100,100,100,100,100,100,100,100,0,0,0,100,100,0,0,0,0,0,0,0,0,0,18,100,100
100,100,0,0,0,100,100,100,0,0,0,100,0,0,0,100,100,0,0,0,100,100,0,0,100,100,100,100,100,100,100,100,100,0,0,0,100,100,0,0,0,0,0,0,0,0,100,100,100,100
100,100,0,0,0,100,100,100,0,0,0,100,0,0,0,100,100,0,0,0,100,100,0,0,0,100,100,0,0,0,100,100,0,0,0,0,100,100,0,0,0,0,0,0,0,0,0,0,100,100
100,100,100,0,0,100,100,100,0,0,0,100,0,0,0,100,100,0,0,0,100,100,100,0,0,100,100,0,0,0,100,100,0,0,0,0,100,100,0,0,0,0,0,0,0,0,0,0,100,100
100,100,100,0,0,100,100,100,100,0,0,100,0,0,0,100,100,0,0,0,100,100,100,0,0,100,100,0,0,0,100,100,0,0,0,0,100,100,0,0,0,0,0,0,0,0,0,0,100,100
100,100,0,0,0,100,100,100,100,0,0,0,0,0,0,100,100,0,0,0,100,100,0,0,0,100,100,0,0,0,100,100,0,0,0,0,100,100,0,0,0,0,0,0,0,0,0,0,100,100
100,100,0,0,0,100,100,100,0,0,0,0,0,0,0,100,100,0,0,0,100,100,0,0,0,100,100,0,0,0,100,100,0,0,0,0,100,100,0,0,0,0,0,0,0,0,0,18,100,100
100,100,0,0,0,100,100,100,0,0,0,0,0,0,0,100,100,0,0,0,100,100,0,0,0,100,100,0,0,0,100,100,0,0,0,0,100,100,0,0,100,21,21,21,21,100,100,100,100,100
100,100,17,17,0,100,100,100,0,0,0,0,0,0,0,100,100,0,0,0,100,100,0,0,0,100,100,0,0,0,100,100,0,0,0,0,100,100,0,0,100,100,100,100,100,100,100,100,100,100
100,100,200,100,15,100,100,100,0,0,0,0,0,0,0,100,100,0,303,0,100,100,0,0,0,100,100,21,21,21,100,100,0,0,24,0,100,100,0,0,100,100,100,100,100,100,100,100,100,100
100,100,100,100,100,100,100,100,100,100,100,100,100,100,100,100,100,100,100,100,100,100,100,100,100,100,100,100,100,100,100,100,100,102,102,100,100,100,100,100,100,100,100,100,100,100,100,100,100,100
100,100,100,100,100,100,100,100,100,100,100,100,100,100,100,100,100,100,100,100,100,100,100,100,100,100,100,100,100,100,100,100,100,100,100,100,100,100,100,100,100,100,100,100,100,100,100,100,100,100
100,100,100,100,100,100,100,100,100,100,100,100,100,100,100,100,100,100,100,100,100,100,100,100,100,100,100,100,100,100,100,100,100,100,100,100,100,100,100,100,100,100,100,100,100,100,100,100,100,100
100,100,100,100,100,100,100,100,100,100,100,100,100,100,100,100,100,100,100,100,100,100,100,100,100,100,100,100,100,100,100,100,100,100,100,100,100,100,100,100,100,100,100,100,100,100,100,100,100,100
100,100,100,100,100,100,100,100,100,100,100,100,100,100,100,100,100,100,100,100,100,100,100,100,100,100,100,100,100,100,100,100,100,100,100,100,100,100,100,100,100,100,100,100,100,100,100,100,100,100
100,100,100,100,100,100,100,100,100,100,100,100,100,100,100,100,100,100,100,100,100,100,100,100,100,100,100,100,100,100,100,100,100,100,100,100,100,100,100,100,100,100,100,100,100,100,100,100,100,100
100,100,100,100,100,100,100,100,100,100,100,100,100,100,100,100,100,100,100,100,100,100,100,100,100,100,100,100,100,100,100,100,100,100,100,100,100,100,100,100,100,100,100,100,100,100,100,100,100,100
